                                                    
       XX                         XX                   
   XX       XX             XXXX                        
   XXX                                                 
   XXXX              P                             XXXX
   XXXXXXXXXXXXXXXXXXXXXXXXXXXXXXXXXXXXXXXXXXXXXXXXX   
   XXXXXXXXXXXXXXXXXXXXXXXXXXXXXXXXXXXXXXXXXXXXXXXXXX  